  NO      ./treerings.xpm 

 

   
SO  ./bricks.xpm
        WE ./walkstone.xpm 
EA                ./waterf3.xpm





F      64,64,64

                         C 127,0,233   

1111111111111111111111111
1100000000110000001000001
1010000011100000010000011
1001000000000000001000001
1100000000000000000100001
100000000011000001110101111111111
10000000000000000000000000001
10000000000000000000001100001
10000001100000000000011000001
10000001100000000000110000011
1W000011000000000001100000001
10000110000000000011000000001
10001100000000000110000000001
11111111111111111111111111111