                 
C   37,253,233 
WE ./walkstone.xpm 

    NO       ./treerings.xpm 
 SO ./bricks.xpm 
EA              ./waterf3.xpm


 
F         187,210,0
1111111111111111
10S0000000000011
1000000010111111
100000001111111
100000001   11
111100011111111    11
   100001000001111
111101100000011
100010000000011
11111111111111
11111111111111

